111111111111111111
1P0000000000000001
10010C000000000001
101E10000000000001
111111111111111111
