111111111111
110000000001
110011110011
100011111111
110000000011
111111111111
