111111111111
11000C000001
1100111P0011
100001111111
110E00000011
111111111111
