111111111111111111
1P0C00E00X0C000011
111111111111111111