111111111111111
1CCCP0CCCCCCCE1
111111111111111