1111111111111111111111111111
1E0000000001000C000000P00001
1111111111111111111111111111