1111111111111111111111111111
1E00000000000000C000000P0001
1111111111111111111111111111